1SSSSDSSSSSSSSSSSSSSSPSSSSSSSSSDSSSSSSSSSSD1
2ssssdssssssssssssssspsssssssssdssssssssssd2
BRRC   CRRRCRHHHCHHH   CRRRRRRRR       RRRRb
BRHR                            RRRRRCCRRRRb
BRRH      CRRRRHCCCRRRRRRR  RR  RRRRRHHRRRRb
BRHRRHHRRRRR          RRRR  RRRRRRRRRHHRCCRb
BRRRR         RRR  R  HHHH  HR  RRRRRCCRRRRb
BRRRR  RRRRRRRRRR  R  HHHH  RR  RRRRRHHRRRRb
BR     RRRR        R        RR           RRb
BRRRR  RRRR  RRRR  RRRRRRRRRRR  RRRRR    RRb
BRHRR    RR                     RRRRR    RRb
BRRRR  RRRRRRRRRR  RRRRRRRCRRRRRRCCCRRRCCRRb
BRRRR  RRRRRRRRRR                        RRb
BRHRR            CCRRRRRRRRRRRRCRRRRRRR  RRb
BRRRR  RRRRRRRRRRRRRRRRRRCRRCRRRRRRRRRR  RRb
BRRRR  RRRRRRRRRRRRRRRRRRRRRRRRR         RRb
BRRRR               RRHHHHHHHHRR  RRRRRRRRRb
BRHRRRRRRRRRRRRRC   RRRRRCCRRRRR  RRRRRRRRRb
BRHRRRRRRRRRRRRRR                 RRRRRRRRRb
3AAAAAAAAAAAAAAAAAAAAAAAAAAAAAAAAAAAAAAAAAA4