1SSSSDSSSSSSSSSSSSSSSPSSSSSSSSSDSSSSSSSSSSD1
2ssssdssssssssssssssspsssssssssdssssssssssd2
BRRCHHHCRRRCRHHHCHHH   CRRRRRRRR       RRRRb
BRHR                            RRRRRCCRRRRb
BRRH      CRRRRHCCCRRRRRRR  RR  RRRRRHHRRRRb
BRHRR  RRRRR          RRRR  RRRRRRRRRHHRCCRb
BRRRR  C      RRR  R  HHHHHHHR  RRRRRCCRRRRb
BRRRR  RRRRRRRRRR  R  HHHH  RR  RRRRRHHRRRRb
BR     RRRR        R        RR           RRb
BRRRR  RRRR  RRRR  RRRRRRRRRRR  RRRRR    RRb
BRHRR    RR                     RRRRR    RRb
BRRRR  RRRRRRRRRR  RRRRRRRCRRRRRRCCCRRRCCRRb
BRRRR  RRRRRRRRRR                        RRb
BRHRR           RCCRRRRRRRRRRRRCRRRRRRR  RRb
BRRRR  RRRRRRRRRRRRRRRRRRCRRCRRRRRRRRRR  RRb
BRRRR  RRRRRRRRRRRRRRRRRRRRRRRRR         RRb
BRRRR               RRHHHHHHHHRR  RRRRRRRRRb
BRHRRRRRRRRRRRRRC   RRRRRCCRRRRR  RRRRRRRRRb
BRHRRRRRRRRRRRRRR                 RRRRRRRRRb
3AAAAAAAAAAAAAAAAAAAAAAAAAAAAAAAAAAAAAAAAAA4