1SSSSDSSSSSSSSSSSSSSSPSSSSSSSSSDSSSSSSSSSSD1
2ssssdssssssssssssssspsssssssssdssssssssssd2
BJJJJJJJJJJJJJJJJJJR   RJ             JJJJJb
BJJJJJJJJJJJJJJJJJJR   RJJJJJJJJJJJ   JJ   b
BJJJ                   CJJJ           JJ   b
BJJJ  JJJJJJJJJJJJJJJJJJJJJ  JJJJJJJJJJJ   b
BJJJ        JJJJJJJJJJJJJJJ  JJ  CC   JJ   b
BJJJJJJJJJ                   JJ    C  JJ   b
BJJ CC JJJ  JJJJJJJJJJJJJJJJJJJJJJJJJJJJ   b
BJJ CC JJJ  JJJJJJJJJR                     b
BJJ CC JJJ  JJJJJJJJJJ  JJJJJJJJJJJJJJJJ   b
BJJJJJJJJJ  JJJJJJJJJJ  JJ     CCC   JJJ   b
BJJ          JJ R JJJJ  JJ     RHR   JJJ   b
BJJ  JJJJJJJJJJJJJJJJJ  JJJJJJJJJJJJJJJJ   b
BJJ  JJJJJJJ   CC   JJ            JJJJJJ   b
BJJ       JJ  RRRR  JJJJJJJJJJJJ  JJJJJJ   b
BJJJJJJJ  JJ   CC       HH JJJJJ           b
BJJHH JJ  JJJJJJJJJJJJJJJJJJJJJJ  JJJJJJ   b
BJJJJJJR                          JJJJJJJJJb
3jjjjjjjjjjjjjjjjjjjjjjjjjjjjjjjjjjjjjjjjjj4