1SSSSDSSSSSSSSSSSSSSSPSSSSSSSSSDSSSSSSSSSSD1
2ssssdssssssssssssssspsssssssssdssssssssssd2
BJJJJJJJJJJJJJJJJJJR   RJ             JJJJJb
BJJJJJJJJJJJJJJJJJJR   RJJJJJJJJJJJ   JJ   b
BJJJ                   CJJJ           JJ   b
BJJJ  JJJJJJJJJJJJJJJJJJJJJ  JJJJJJJJJJJ   b
BJJJ        JJJJJJJJJJJJJJJ  JJ  CC   JJ   b
BJJJJJJJJJ                   JJ    C  JJ   b
BJJJCC JJJ  JJJJJJJJJJJJJJJJJJJJJJJJJJJJ   b
BJJJCC JJJ  JJJJJJJJJR                     b
BJJJCC JJJ  JJJJJJJJJJ  JJJJJJJJJJJJJJJ    b
BJJJJJJJJJ  JJJJJJJJJJ  JJ     CCC   JJ    b
B            JJ R JJJJ  JJ     RHR   JJ    b
B    JJJJJJJJJJJJJJJJJ  JJJJJJJJJJJJJJJ    b
B    JJJJJJJ   CC   JJ            JJJJJ    b
B         JJ  RRRR  JJJJJJJJJJJJ  JJJJJ    b
B         JJ   CC       HH JJJJJ           b
BHRHR     JJJJJJJJJJJJJJJJJJJJJJ  JJJJJJ   b
BRHRH                             JJJJJJJJJb
3jjjjjjjjjjjjjjjjjjjjjjjjjjjjjjjjjjjjjjjjjj4