1SSSSDSSSSSSSSSSSSSSSPSSSSSSSSSDSSSSSSSSSSD1
2ssssdssssssssssssssspsssssssssdssssssssssd2
BRRC   HCHH  HHHHHHH   CRRRRRRRRR      RRRRb
BRHR   RCRR   RCR              RRRRR   RRRRb
BRRH               RRRRRRH HRRRRRRRR   RRRRb
BRHRR  RRRRRRRRRRCCRRRRRRH HRRRRRRRR   RCCRb
BRRRR  RRRCCCCRRRCCRHHHHHH CRR  RRRR   RRRRb
BRRRR  RRRRRRRRRR          CRR  RRRR   RRRRb
BR     RRRR        RHHHHHHHHRR           RRb
BRRRR  RRRR  RRRR  RRRRRRRRRRR  RRRRR    RRb
BRHRR                      C    RRRRR    RRb
BRRRR  RRRRRRRRRR  RRRRRRRCRRRRRRCCCRRR  RRb
BRRRR  RRRRRRRRRR  R         C           RRb
BRHRR              RRRRRRRRRRRRCRRRRRRR  RRb
BRRRR  RRRRRRRRRRRRRRRRRRCRRCRRRRRRRRRR  RRb
BRRRR  RRRRRRRRRRRRRRRRRRRRRRRRR         RRb
BRRRR               RRHHHHHHHHRR  RRRRRRRRRb
BRHRRRRRRRRRRRRRC   RRRRRCCRRRRR  RRRRRRRRRb
BRHRRRRRRRRRRRRRR                 RRRRRRRRRb
3AAAAAAAAAAAAAAAAAAAAAAAAAAAAAAAAAAAAAAAAAA4 