1SSSSDSSSSSSSSSSSSSSSPSSSSSSSSSDSSSSSSSSSSD1
2ssssdssssssssssssssspsssssssssdssssssssssd2
BRRC   CRRRCRHHHCHHH   CRRRRRRRR       RRRRb
BRHR   RCRRRRCRRR               RRRRR  RRRRb
BRRH      CH       RRRRRRRRRRR  RRRRR  RRRRb
BRHRR  RRRRRRRRRR  RRRRRRRRRRRRRRRRRR  RCCRb
BRRRR  RRRCCCCRRR  RHHHHHHHHHR  RRRRR  RRRRb
BRRRR  RRRRRRRRRR  RRR   C  RR  RRRRR  RRRRb
BR     RRRR        RRHHHHHHHRR           RRb
BRRRR  RRRR  RRRR  RRRRRRRRRRR  RRRRR    RRb
BRHRR                      C    RRRRR    RRb
BRRRR  RRRRRRRRRR  RRRRRRRCRRRRRRCCCRRR  RRb
BRRRR  RRRRRRRRRR  R         C           RRb
BRHRR              RRRRRRRRRRRRCRRRRRRR  RRb
BRRRR  RRRRRRRRRRRRRRRRRRCRRCRRRRRRRRRR  RRb
BRRRR  RRRRRRRRRRRRRRRRRRRRRRRRR         RRb
BRRRR               RRHHHHHHHHRR  RRRRRRRRRb
BRHRRRRRRRRRRRRRC   RRRRRCCRRRRR  RRRRRRRRRb
BRHRRRRRRRRRRRRRR                 RRRRRRRRRb
3AAAAAAAAAAAAAAAAAAAAAAAAAAAAAAAAAAAAAAAAAA4 