MMMMMMMMMMMMMMMMMMMMMMMMMMMMMMMMMMMMMMMMMMMM
M        M                                 M
M                                          M
M              M                           M
M                                          M                             
M                                          M
M                                          M
M                   M                      M
M                                          M
M                                          M
M                                          M
M                                          M
M               M                          M
M                                          M
M                                          M
M                           M              M
M                                          M
M                                          M
M                    M                     M
MMMMMMMMMMMMMMMMMMMMMMMMMMMMMMMMMMMMMMMMMMMM